1111111111111111111111111111111111111111
1000000000000000000000000000000000000001
1000000000000000000000000000000000000001
1000000000000000000000000000000000000001
1000000000000000000000000000000000000001
1111111111111000000000000000000000000001
1000000000000000000000000000000000000001
1000000000000000000000000000000000000001
1000000000000000001111111100000000000001
1000000000000000000000000100000000000001
1111110000000000000000000111111110000001
1111111111110000000000000000000000000001
1111000000000000000000000000000000000001
1000000000000000000000000000000000000011
1000000000000000100000000000000000000111
1000000000000111111100000000000000001111
1000000111111110000000000000000000011111
1000000000000000000000000000011111111111
1100000000000000000000000000000000000001
1110000000000000000000000000000000000001
1111110000000000000000000000000000000001
1111111111111111111111111111111111111111
1111111111111111111111111111111111111111
